cd $HADOOP_HOME
bin/hadoop fs -put $HadoopInPractice_HOME/data/names?.txt input
mkdir jobs
cd jobs
jar cvf HadoopInPractice.jar -C $HadoopInPractice_HOME/bin .
cd ..
bin/hadoop fs -rmr output
bin/hadoop ./jobs/HadoopInPractice.jar ch1.Driver input/names?.txt output
bin/hadoop fs -cat output/part-r-00000


#after those steps ,you will get
ADAMS	names1.txt,
ADKINS	names2.txt,
AGUILAR	names2.txt,
ALEXANDER	names1.txt,
ALLEN	names1.txt,
ANDERSON	names1.txt,
BAILEY	names1.txt,
BAKER	names1.txt,
BALDWIN	names2.txt,
BARBER	names2.txt,
BARNES	names1.txt,
BECKER	names2.txt,
BELL	names1.txt,
BENNETT	names1.txt,
BENSON	names2.txt,
BLAIR	names2.txt,
BOWEN	names2.txt,
BROOKS	names1.txt,
BROWN	names1.txt,
BRYANT	names1.txt,
BURGESS	names2.txt,
BUTLER	names1.txt,
CAMPBELL	names1.txt,
CANNON	names2.txt,
CARTER	names1.txt,
CLARK	names1.txt,
COHEN	names2.txt,
COLE	names1.txt,
COLEMAN	names1.txt,
COLLINS	names1.txt,
CONNER	names2.txt,
COOK	names1.txt,
COOPER	names1.txt,
COX	names1.txt,
CROSS	names2.txt,
CUMMINGS	names2.txt,
DANIEL	names2.txt,
DAVIS	names1.txt,
DELGADO	names2.txt,
DENNIS	names2.txt,
DIAZ	names1.txt,
EDWARDS	names1.txt,
ERICKSON	names2.txt,
EVANS	names1.txt,
FARMER	names2.txt,
FLORES	names1.txt,
FORD	names1.txt,
FOSTER	names1.txt,
FRANCIS	names2.txt,
GARCIA	names1.txt,
GARNER	names2.txt,
GLOVER	names2.txt,
GONZALES	names1.txt,
GONZALEZ	names1.txt,
GOODMAN	names2.txt,
GOODWIN	names2.txt,
GRAHAM	names1.txt,
GRAY	names1.txt,
GREEN	names1.txt,
GRIFFIN	names1.txt,
GRIFFITH	names2.txt,
HALL	names1.txt,
HAMILTON	names1.txt,
HAMPTON	names2.txt,
HARMON	names2.txt,names1.txt,
HARRIS	names1.txt,
HAYES	names1.txt,
HENDERSON	names1.txt,
HERNANDEZ	names1.txt,
HIGGINS	names2.txt,
HILL	names1.txt,
HINES	names2.txt,
HODGES	names2.txt,
HOWARD	names1.txt,
HUBBARD	names1.txt,names2.txt,
HUGHES	names1.txt,
INGRAM	names2.txt,
JACKSON	names1.txt,
JAMES	names1.txt,
JENKINS	names1.txt,
JOHNSON	names1.txt,
JONES	names1.txt,
JOSEPH	names2.txt,
KELLY	names1.txt,
KING	names1.txt,
LEE	names1.txt,
LEWIS	names1.txt,
LONG	names1.txt,
LOPEZ	names1.txt,
LYONS	names2.txt,
MACK	names2.txt,
MALDONADO	names2.txt,
MANN	names2.txt,
MANNING	names2.txt,
MARTIN	names1.txt,
MARTINEZ	names1.txt,
MCGEE	names2.txt,
MILLER	names1.txt,
MITCHELL	names1.txt,
MOORE	names1.txt,
MORGAN	names1.txt,
MORRIS	names1.txt,
MOSS	names2.txt,
MULLINS	names2.txt,
MURPHY	names1.txt,
MYERS	names1.txt,
NELSON	names1.txt,
NEWTON	names1.txt,names2.txt,
ORTEGA	names2.txt,
PARKER	names1.txt,
PATTERSON	names1.txt,
PATTON	names2.txt,
PEREZ	names1.txt,
PERRY	names1.txt,
PETERSON	names1.txt,
PHILLIPS	names1.txt,
POTTER	names2.txt,
POWELL	names1.txt,
PRICE	names1.txt,
RAMIREZ	names1.txt,
RAMSEY	names2.txt,
REED	names1.txt,
REESE	names2.txt,
REEVES	names2.txt,names1.txt,
RICHARDSON	names1.txt,
RIOS	names2.txt,
RIVERA	names1.txt,
ROBBINS	names1.txt,names2.txt,
ROBERTS	names1.txt,
ROBINSON	names1.txt,
RODGERS	names1.txt,names2.txt,
RODRIGUEZ	names1.txt,
ROGERS	names1.txt,
ROSS	names1.txt,
ROWE	names2.txt,
RUSSELL	names1.txt,
SALAZAR	names1.txt,names2.txt,
SANCHEZ	names1.txt,
SANDERS	names1.txt,
SANTOS	names2.txt,
SCHNEIDER	names2.txt,
SCOTT	names1.txt,
SHARP	names2.txt,
SIMMONS	names1.txt,
SMITH	names1.txt,
STEVENSON	names2.txt,
STEWART	names1.txt,
STRICKLAND	names2.txt,
SULLIVAN	names1.txt,
SWANSON	names2.txt,
TATE	names2.txt,
TAYLOR	names1.txt,
THOMAS	names1.txt,
THOMPSON	names1.txt,
THORNTON	names2.txt,
TODD	names2.txt,names1.txt,
TORRES	names1.txt,
TOWNSEND	names2.txt,
TURNER	names1.txt,
VALDEZ	names2.txt,
VEGA	names2.txt,
WALKER	names1.txt,
WALLACE	names1.txt,
WALTON	names2.txt,
WARD	names1.txt,
WARNER	names1.txt,names2.txt,
WASHINGTON	names1.txt,
WATSON	names1.txt,
WEBSTER	names2.txt,
WHITE	names1.txt,
WILLIAMS	names1.txt,
WILSON	names1.txt,
WOLFE	names2.txt,
WOOD	names1.txt,
WOODS	names1.txt,
WRIGHT	names1.txt,
YATES	names2.txt,
YOUNG	names1.txt,